TODO
compare with the previous version
Kerning groups
merge old OT code

GENERATE
zeroinferior=zero.sinf
oneinferior=one.sinf
twoinferior=two.sinf
threeinferior=three.sinf
fourinferior=four.sinf
fiveinferior=five.sinf
sixinferior=six.sinf
seveninferior=seven.sinf
eightinferior=eight.sinf
nineinferior=nine.sinf
zerosuperior=zero.sups
onesuperior=one.sups
twosuperior=two.sups
threesuperior=three.sups
foursuperior=four.sups
fivesuperior=five.sups
sixsuperior=six.sups
sevensuperior=seven.sups
eightsuperior=eight.sups
ninesuperior=nine.sups

zero.sinf=zero.subs
one.sinf=one.subs
two.sinf=two.subs
three.sinf=three.subs
four.sinf=four.subs
five.sinf=five.subs
six.sinf=six.subs
seven.sinf=seven.subs
eight.sinf=eight.subs
nine.sinf=nine.subs

at=at.case
hyphen=hyphen.case
endash=endash.case
emdash=emdash.case
periodcentered=periodcentered.case
bullet=bullet.case
slash=slash.case
backslash=backslash.case
parenright=parenright.case
bracketleft=bracketleft.case
bracketright=bracketright.case
braceleft=braceleft.case
braceright=braceright.case
guilsinglleft=guilsinglleft.case
guilsinglright=guilsinglright.case
guillemetleft=guillemetleft.case
guillemetright=guillemetright.case



INCONSISTENCIES
Ldot cat
inferior subs sinf
fractions
prime >> primemod?